█████████████████████████
█A     █         █     █
█ ████ █ ███████ █ ███ █
█ █    █     █   █   █ █
█ █ ████████ █ █████ █ █
█ █ █      █ █       █ █
█ █ █ ███████████ ██████
█   █   █       █      █
██████ █████ █████ ███ █
█      █     █     █   █
█ ████████████████ ███ █
█ █                █   █
█ █ █████ ███████████ █
█ █   █   █          █ █
█ █████ █████ ██████ █ █
█       █      █     █ █
█████ ██████████ ███ █ █
█     █          █   █ █
█ █████ █████████████ █B
████████████████████████